11 3
00000000000
00000000000
00000000000
00002202200
00000000000
00000000000
20202210002
00000000000
00000000000
00000000000
00000000000
